0 , 0 , 0 , 0 , 0 , 0 , 0 , 0 , 0 , 0 , 0 , 0 , 0 , 0 , 0 , 0 , 0 , 0 , 0 , 0
0 , 0 , 1 , 1 , 1 , 1 , 1 , 0 , 0 , 0 , 0 , 0 , 1 , 1 , 1 , 1 , 0 , 0 , 0 , 0
0 , 0 , 7 , 0 , 0 , 0 , 1 , 0 , 16 , 0 , 0 , 0 , 7 , 0 , 0 , 1 , 0 , 16 , 0 , 0
0 , 0 , 1 , 1 , 1 , 0 , 1 , 0 , 1 , 0 , 0 , 0 , 1 , 0 , 0 , 1 , 0 , 1 , 0 , 0
0 , 1 , 1 , 0 , 0 , 0 , 1 , 7 , 1 , 1 , 0 , 0 , 1 , 0 , 0 , 1 , 0 , 1 , 0 , 0
0 , 1 , 0 , 0 , 0 , 0 , 0 , 0 , 0 , 1 , 0 , 0 , 1 , 0 , 0 , 1 , 0 , 1 , 1 , 0
0 , 1 , 0 , 1 , 1 , 1 , 1 , 0 , 0 , 1 , 0 , 0 , 1 , 0 , 0 , 1 , 1 , 0 , 1 , 0
0 , 1 , 0 , 1 , 0 , 0 , 0 , 0 , 0 , 1 , 0 , 0 , 1 , 0 , 0 , 0 , 1 , 0 , 1 , 0
0 , 6 , 1 , 1 , 0 , 1 , 1 , 1 , 1 , 1 , 0 , 0 , 1 , 0 , 0 , 0 , 1 , 0 , 1 , 0
0 , 1 , 0 , 0 , 0 , 1 , 0 , 1 , 0 , 0 , 0 , 1 , 1 , 0 , 0 , 0 , 7 , 0 , 1 , 0
0 , 1 , 0 , 0 , 0 , 1 , 0 , 1 , 0 , 0 , 0 , 1 , 0 , 0 , 0 , 0 , 1 , 0 , 1 , 0
0 , 1 , 0 , 0 , 0 , 7 , 0 , 1 , 0 , 15 , 1 , 1 , 1 , 7 , 0 , 0 , 1 , 0 , 1 , 0
0 , 1 , 0 , 15 , 0 , 1 , 0 , 1 , 0 , 1 , 0 , 0 , 0 , 1 , 0 , 0 , 1 , 1 , 1 , 0
0 , 1 , 0 , 1 , 0 , 0 , 0 , 1 , 1 , 1 , 0 , 0 , 0 , 1 , 1 , 1 , 0 , 0 , 7 , 0
0 , 7 , 1 , 1 , 1 , 1 , 0 , 0 , 1 , 0 , 0 , 0 , 0 , 1 , 0 , 1 , 1 , 0 , 1 , 0
0 , 0 , 1 , 0 , 0 , 0 , 1 , 1 , 1 , 0 , 0 , 0 , 0 , 1 , 0 , 0 , 0 , 0 , 1 , 0
0 , 0 , 1 , 0 , 17 , 1 , 1 , 0 , 1 , 0 , 0 , 0 , 1 , 1 , 1 , 7 , 0 , 0 , 1 , 0
0 , 0 , 1 , 0 , 0 , 0 , 0 , 0 , 1 , 0 , 0 , 0 , 1 , 0 , 0 , 1 , 0 , 0 , 1 , 0
0 , 0 , 1 , 1 , 1 , 1 , 0 , 0 , 16 , 1 , 1 , 1 , 1 , 0 , 0 , 1 , 1 , 1 , 5 , 0
0 , 0 , 0 , 0 , 0 , 0 , 0 , 0 , 0 , 0 , 0 , 0 , 0 , 0 , 0 , 0 , 0 , 0 , 0 , 0